11 27
0 1 0 0 0 0 0 0 0 0 0 1 1 1 0 0 2 0 1 1 1 1 1 1 0 0 0
0 1 0 1 1 2 1 1 1 1 0 1 0 1 1 1 1 0 0 0 0 2 0 0 1 1 0
0 1 0 1 0 0 1 0 0 4 0 1 0 2 0 0 0 0 1 1 1 0 1 0 4 1 0
0 1 0 1 1 1 1 1 1 1 0 1 1 1 1 1 1 0 1 4 1 2 1 0 1 1 0
0 1 0 0 4 0 0 0 0 1 0 2 0 1 4 0 0 0 1 0 0 0 0 0 0 0 0
0 1 1 1 0 1 1 1 1 1 0 1 1 1 0 1 1 0 1 0 1 1 0 1 0 1 0
0 0 0 0 0 0 0 0 0 0 0 0 0 0 0 4 1 0 1 0 0 1 0 1 0 1 0
1 1 1 1 0 1 1 1 1 1 1 1 2 1 0 1 1 2 1 0 1 1 0 1 0 1 0
1 0 0 1 0 0 4 1 4 0 2 0 0 1 0 1 0 0 1 0 1 0 0 1 0 1 0
1 0 0 1 1 1 0 1 1 1 1 1 1 1 0 1 1 1 1 0 1 1 1 1 0 1 0
1 1 0 0 2 0 0 0 0 0 0 0 0 0 0 2 0 0 0 0 0 0 0 0 0 1 0
4
0 0
10 26
0 24
8 16